aandrijfkettingen	aandrijfketting
aandrijfrollen	aandrijfrol
aandrukkers	aandrukker
aanvoerbanden	aanvoerband
afduwers	afduwer
afschuivers	afschuiver
bufferbanden	bufferband
bufferbandje	bufferband
de-palletiseerder	deplletiseerder
doortrekunit	doortrekblok
gietbomen	gietboom
gietwagens	gietwagen
grondgraafmachine	grondgraver
hijsbanden	hijsband
karrenbelader	karbelader
keerrollen	keerrol
kettingbanen	kettingbaan
kettingwielen	kettingwiel
moederauto	moederwagen
onstapelaar	ontstapelaar
ontstapelaars	ontstapelaar
opstapelaars	opstapelaar
overschuivers	overschuiver
palletiseerders	palletiseerder
palletiseermachine	palletiseerder
palletiser	palletiseerder
palletizeerder	palletiseerder
palletizer	palletiseerder
palletonstapelaaar	palletontstapelaar
pallitiseerder	palletiseerder
tegenhouders	tegenhouder
uitrijwagens	uitrijwagen
wielbouten	wielbout
zaaidrums	zaaidrum
zaaikammen	zaaikam
zaaiplaten	zaaiplaat
zaaitrommels	zaaitrommel
